GeneID,PrimerPair1,PrimerSeq_F,PrimerLoc_F,PrimerSeq_R,PrimerLoc_R,GeneLength_no_padding,GeneLength_with_padding,Primer_coverage
gene_1014,513,GCTTGAGTTGCCAGATCAGC,853,ACAATGAGTGGGTGGGCTC,3389, 2245, 4245, 2536
gene_11990,5545,AAAAACGCCGCATTCTTGGG,479,GCTTAGCGGTGTACAAGCAT,2608, 1485, 3485, 2129
gene_12107,2169,TCGCTACCACATCTTGCATG,861,CGTTGAACGGAACCTTGTCC,2633, 1452, 3452, 1772
gene_12935,6827,CGGATGAGACTGCTTGTCCT,777,CTATGCCCCTGTCAGGAGGT,2732, 1606, 3606, 1955
gene_12969,9778,GTGTCCCCTAGACTCATGACTC,784,ATCCCAGACGTTCCCCTCT,2519, 1303, 3303, 1735
gene_22265,9825,ATGACTGGTACACGCTTGCG,748,AGTGCCAGAATTGTAGCATGG,2740, 1427, 3427, 1992
gene_25275,6869,CGCTGCAGCATCATAGATCC,658,TCGCGGTATCTTCCCTCCC,2975, 1824, 3824, 2317
gene_29070,2915,ATGTGACTTGGTCGGACAGG,720,GTTCTGGACCCGTGACACC,2985, 1851, 3851, 2265
gene_3331,3219,CACCTCTCCTCCTCCTCCTC,829,TGCGTACGAGCTCAGCG,3425, 2273, 4273, 2596
gene_7839,7882,CGCGTCCAACCATTGAGATG,734,TGGTCCAGATAAGCTGTTGC,2614, 1478, 3478, 1880
gene_8103,6740,TTGTTGTGGACATCAAGAGACA,718,AATCAAAACTGGGAGGCTCC,3227, 1787, 3787, 2509
gene_16256,6918,GTACGCACAAGACAACCACA,879,TGGAAATCCACATTCCCCTAAA,3507, 2159, 4159, 2628
gene_16463,3557,ACCCCCAAAAGAATCGAGGC,725,CCCGAACCACCAATTCCCAG,2585, 1466, 3466, 1860
gene_16847,9580,CAGTCACCATGAGCTCATCA,667,TGAGGGAAGCAGAACGTCTG,3197, 1989, 3989, 2530
gene_16891,5673,GGACAGGCGATCCACTACAT,710,TGGATCCGATCGGGGTCTC,3189, 2062, 4062, 2479
gene_20599,3193,GGTTGCGGTGAATTACGATTGT,878,CGTTGCACATCTGGTCGAAG,2790, 1554, 3554, 1912
gene_22349,5826,CCCTTCCACACGAGTAAAAGC,630,CATTTATCCTGCGGGGGGAG,2373, 1234, 3234, 1743
gene_22506,188,TGGCAGGTGTCGTTCTTTCA,650,CCCGTTGCTTGGAGATAGCA,1649, 359, 2359, 999
gene_24108,8167,CCAGCCCAAGCAGAGAGAAA,543,AGAAAGAGGGAGAGGGACAGA,2818, 1698, 3698, 2275
gene_25288,2960,ATACTGATGGTCACGACGGC,393,CCAGAGGAAATCACTTGTGGC,3179, 2059, 4059, 2786
gene_26852,9191,TCTAACGCAGGAGTGAGAGGT,671,CCGATTGGACCATGTTGCCT,1680, 510, 2510, 1009
gene_27168,9092,GCACAAACGCTTCATTATGGGT,863,CCTGGTTGACTGTGAACCCA,3112, 1907, 3907, 2249
gene_28234,1271,CCCTGTCTGTCCCAGCTCTA,856,CCTCTCTCCTCCTCCCTGAA,2413, 1238, 3238, 1557
gene_2829,9625,GGGTAAAGTTTTGGCTGATCCC,857,AATCAGCCCAGACCATGTCG,2973, 1721, 3721, 2116
gene_2965,6035,ATTTCTGAGGTGCAGTAGGTACA,721,GGATTGACGTTGGTTTGCAA,3005, 1792, 3792, 2284
gene_10660,6210,GTTTGAACGGCTCCGAACC,118,ACCGAACACCAATCTCTCCA,2921, 1725, 3725, 2803
gene_10937,8507,TCAGGAAGAGCTTGTCGAGA,866,CGGCGATAGTTGTACGGAGT,2686, 1526, 3526, 1820
gene_11632,7517,ACTGGGGGGTCTTTGAAGAG,873,GTGTTCCCATAAACTCAAGCCA,3098, 1921, 3921, 2225
gene_12384,9765,TATCTGTGTGAGTCCTGCGG,876,AGTGAAGTTGCACGGAAGGC,2787, 1547, 3547, 1911
gene_14659,9352,GTTGCTGGATCACTGGATGA,480,TCTTACCCCCGTCCCCGA,3111, 1984, 3984, 2631
gene_15992,2039,CGTCGTCATGAGGAAAAAGAAGG,663,CCCACTGGACTAGCACCAC,2565, 1395, 3395, 1902
gene_17164,6191,GTGGGATTTCGCCAGAGTTT,372,GACCAGGAGAGTCAAGTGGA,2541, 1322, 3322, 2169
gene_17633,7408,GGTGCAGTGGCTGGGAA,788,GCCCAATCAACCAGTGTGG,3475, 1863, 3863, 2687
gene_17976,2283,TAGGCTTGACCCGACGAAAG,816,CCCGTGGGCTTGATATCTACC,2701, 1574, 3574, 1885
gene_21376,9587,TTGGCAAGGAGTGGAGTGAG,812,CCGCTATAAAGGCCTATCACGT,2470, 1328, 3328, 1658
gene_22903,5195,GGAGCCAAGCTGGAGAAGAA,854,CCGAATCGTTTGTCCCCCC,2937, 1792, 3792, 2083
gene_23733,8672,CACCCTTCTCTCTTTCCCCA,693,TCGCCATCGATGATGATGAAGA,2701, 1467, 3467, 2008
gene_25139,6258,CTCTAGTCACGTGCTGCCAG,758,AGTGTCGAGTTCCAAGATCGT,2610, 1459, 3459, 1852
gene_28124,2007,CAGTAGGCTGACGTTTTGCC,609,CCTAGGTAGCCTGACCGTTTC,2744, 1624, 3624, 2135
gene_3882,6419,TGCTGATGTGAAAGGGGAACA,242,GTGAGAGCACATTGGCTGGA,2666, 1311, 3311, 2424
gene_4734,9743,TGACGTGTGTGTGTGAATAAGA,832,GCGACACTTAGGATTCCCCC,3143, 1804, 3804, 2311
gene_8614,8841,CCCCCCAATCTGTGATCTCAC,393,TGATCTTCGCCTGCTTGCC,3122, 1978, 3978, 2729
gene_9779,1998,GCTTGGTTCCTCTGATGGCT,809,CGAGTTCATAGAAGAGGGGGG,2967, 1779, 3779, 2158
gene_9939,8992,CCCACTGGACTAGCACCAC,829,ACAAAAAAAAGGACCAAGGAGGA,2522, 1396, 3396, 1693
gene_1093,4193,CCAGGAATTGAGCCGTCGAA,276,TCCCATTGCTGGATCGTCCT,1996, 877, 2877, 1720
gene_15619,9031,TGACTCAAGAAACAAGCGTGG,517,GTGGGTGGTTGAAGGGAGAG,2342, 1049, 3049, 1825
gene_16844,8703,AACAAGAGAGAGAGAGAGAGGT,859,TATGGAGGACGAAGGTCGGA,3576, 2402, 4402, 2717
gene_17715,7316,AGGCGACACGAGGATGAGAA,795,GCTGCTGCTTCCTCCTGA,2758, 1641, 3641, 1963
gene_27391,4807,GATGGGGAACTCAAAGCCCA,839,GTATTTTGATGCCGCGGAGA,2234, 1115, 3115, 1395
gene_28182,7098,CTCTGGCCAATGACCCCAA,812,ACCACCTTCCTTCGACTCATC,3473, 2342, 4342, 2661
gene_29739,1701,CGAAGGTATATCACGCTGCCA,850,GGCAGATGGGCAAGATGGAT,3023, 1871, 3871, 2173
gene_3826,4951,GTACCTTGTCATCGACACCG,600,ACTCGTCAGCTTGAGTGAGC,1652, 294, 2294, 1052
gene_6353,5033,GGGCGAAGTTCTTTGGTCGA,626,GTCCGTTGGAGATGCTCTGA,2857, 1738, 3738, 2231
