GeneID,PrimerPair,PrimerSeq_F,PrimerLoc_F,PrimerSeq_R,PrimerLoc_R,GeneLength_no_padding,GeneLength_with_padding,Primer_coverage
gene_2913,6112,TCCAGTCTTGAAGAGAGAGAGAG,212,CTGCTTTTTCCTCCCCCTGG,2377,1258,3258,2165
gene_12549,4709,CCCAGATCACGCTCATGCA,244,ATTGCTCGAAAGGGGCTGAG,2479,1327,3327,2235
gene_27679,6101,ACTACCATCAACGAGGGTGA,347,ACGCGAACAATTCACCAGTT,2651,1417,3417,2304
gene_14090,5862,CGGAGACCTTTCCAATGGAG,29,CGTTTTGGCCAGGGATTGTC,2705,1482,3482,2676
gene_21354,9233,GACCAACTCATCTCCGATGGA,426,GTATCAGCTCGGCCCTTGG,2790,1618,3618,2364
gene_2088,9010,AGGATGTTCCCATGCCAAGG,848,GACCAAGGTTGAGCTTGTATCT,3223,1705,3705,2375
gene_9251,6772,ATGGTCGAGATACCTTTTGCG,35,TGCAAGGAGAAAAAGGGATGA,2900,1741,3741,2865
gene_5170,9705,ACCACTTCTTACATCGCCAC,873,TTGGAAGCGGTTGATTTGCG,3196,1749,3749,2323
gene_18935,6183,GCCAATTCTCGAAGGGTGAC,410,GCTCTGACCAGTTCCCATTGT,2886,1756,3756,2476
gene_25217,6098,GGGGGATGTGTCTTTCGATCT,358,TGTCCGCCAAAGAGAGACAA,3082,1757,3757,2724
gene_1126,9429,ACACTTGAAGGACTCATTGCT,832,TTGTGCAGTTGGATGGTCCA,2936,1774,3774,2104
gene_27455,1752,GTCACTACTGGGCGAGAAGT,260,GCGGTACTCTCCTTCGAGTC,2939,1801,3801,2679
gene_12774,4007,CATGGCTGTGGGCTGTCA,717,CGCATGACCAAGCCATATGC,3145,1823,3823,2428
gene_7629,5884,CTTACCCCGTCTTATGTCGACC,787,TTATCGATCGTCACTGCGGG,3078,1837,3837,2291
gene_28944,8915,TGAGGATGACTGAGGAGGATGA,829,ACAAGCTTCTTCCCCATCGA,3010,1854,3854,2181
gene_3505,9276,TCAAGGTTTGCTCTCGATGGA,774,GGGAGAGTGAACGAGAAGTGT,3108,1920,3920,2334
gene_24273,316,ATGTGGCTGTGTCAAAGTAGC,818,CCCGCCCTTGATGATAATGA,3089,1944,3944,2271
gene_2297,6166,TGGGTGACGGAAAATCGGAC,632,AGAAAAGGTCAGTTGGTGTCCT,3083,1962,3962,2451
gene_4649,7395,ACTCATCCACGCATCTTCTC,510,ATCTTGAGAGGCTTACGCGC,3126,2007,4007,2616
gene_20765,8611,CACACACAATGACCTCCCCT,277,CTCGTCAGGCTACCCCAAA,2896,1201,3201,2619
gene_24274,1178,GCGGAATGTGGTGGAGAAGA,801,TCAGGGGGTTTCAAGTGTGTTT,2797,1518,3518,1996
gene_17077,8367,TATCTCCGAAACCCCACAGC,874,GAGACTCCTGATGTCCGGGG,3398,1653,3653,2524
gene_15601,7302,CGCTGGACTCCTTTGGGTTA,748,GCCATGTCCTTTGATTGCGAT,3395,1740,3740,2647
gene_12690,5069,GCGACCAAGGTTCTCTCTCC,822,ATGTCTCCTTGAGTCCCGGC,3522,1769,3769,2700
gene_4637,6468,GCGGAGTGGAGGTTCATTCA,858,TCACCTTGGACTGCACTACAT,2971,1770,3770,2113
gene_3881,3513,CCAGCTCCCATGAGACACAT,848,GGGCGATGTTCCCCTTTCA,3560,1847,3847,2712
gene_9558,6614,GGGGAATCCAAAGACATGGGT,834,TTGAGGAGGGGGAAAAGGAAA,3562,1863,3863,2728
