GeneID,PrimerPair,PrimerSeq_F,PrimerLoc_F,PrimerSeq_R,PrimerLoc_R,GeneLength_no_padding,GeneLength_with_padding,Primer_coverage
gene_1594,19461,AGCTGTAGGAAACTTGGCATCT,749,TGACGTACACAAAAGACTTCCAG,3621, 2388, 4388, 2872
gene_7878,14960,GCGCAAGTTTACCACACAACT,737,TGCCGTCGTTATCTATAGAAGCT,3604, 2380, 4380, 2867
gene_3331,18961,TGTGCTTGAGAAGAAAGATGGT,696,ACCTTGAATCAAATCAATCTCAAGAGT,3503, 2273, 4273, 2807
gene_1493,17807,CACTCGCTACTAGGCTGCC,750,CTCTTCCAGATGAAATACACCCA,3481, 2258, 4258, 2731
gene_9539,7384,ACTGCTGATCGAAGCCTACA,771,ACCTCATGGTCCAGGTATCT,3556, 2194, 4194, 2785
gene_2949,11624,CATCATTGCTTTAGTTTCTTGTAGTC,728,CTCAATTTTTAATGATTTTGGTCGGA,3437, 2155, 4155, 2709
gene_2927,7607,CTCAATTTTTAATGATTTTGGTCGGA,715,TCTCACACGCTTGCTTGG,3366, 2133, 4133, 2651
gene_4932,9346,TATTCCTTCATGGTTCAGCGAGA,683,CGGGTTTTTCGAGTAACTTTGGA,3485, 2114, 4114, 2802
gene_18329,12257,TGGACAGGCGATCTACTACA,717,GGTGGCCCAGCTACACAAG,3328, 2088, 4088, 2611
gene_20937,5083,CCCGCTTCTCTTCCTCTGC,723,GGGGCTAAGAACGTTGGATCT,3306, 2076, 4076, 2583
gene_14949,5523,AGTGAAAGTGGGCAGTGCTT,744,CGGTCGAACCTGATTTGGAA,3284, 2059, 4059, 2540
gene_7280,11827,GGCGACATGATTCTTCCAGA,540,GTGATGAAAATTCCCCGCCT,3252, 2016, 4016, 2712
gene_9768,7253,TGTCATTCTACACGCCTGAAA,777,TGTTTGAGCGGAATGTGGAT,3314, 1988, 3988, 2537
gene_2617,10448,TTGTCGGACGGGCTTGTC,457,AAAGCTGGAGTGCCCTCAA,3175, 1957, 3957, 2718
gene_16853,16130,CCCCCCAATATCGAAACCCA,474,CGTCATGCAGTTAGTTCAAGCA,3204, 1954, 3954, 2730
gene_25175,10414,TGTGACCGAGGATGGAAAACT,754,TTCTCCACTCTCCACTTGCC,3139, 1919, 3919, 2385
gene_13925,11993,CCCGTCTAGCTGATTCGTCA,775,GGCCACAAGGAATGAAAGTCTC,3162, 1914, 3914, 2387
gene_18873,19221,GCGTTGCAAGGAGACGAAAA,594,GCCCTAGATCTGTTTTGACGTG,3116, 1887, 3887, 2522
gene_29739,11680,GGACAAGCTTCAGGTTTCCT,602,CGGACCGCCAGTGTTTTTTC,3100, 1871, 3871, 2498
gene_23723,18367,CGCGAATGTAGGACAAGCTTA,623,CAACAGTGCGGGTTAATGCC,3103, 1870, 3870, 2480
gene_4416,19249,TCCCCACGTGTGATTTCAC,244,GCAGTGAACATCGTTGAGCT,3088, 1869, 3869, 2844
gene_24220,16206,GAAATTTTCCCTGGCCGGC,553,GTAAGCTACGTGGGCGGC,3329, 1856, 3856, 2776
gene_29070,13388,GGACAGGCCCCAATCTTCG,733,CACTCCGGCTCCGATGAAG,3119, 1851, 3851, 2386
gene_5966,17585,AAACAAAAGGACGGGGCAGA,732,CCAAGTCAGATTATGGACCCCT,3067, 1846, 3846, 2335
gene_27287,14113,TGGTTCGTGCTTGGTTCTTG,765,TCTAAGCCAGGCTTCGGC,3130, 1839, 3839, 2365
gene_12774,18692,CACTTCACTCAAAGCCATGGC,702,TGAGGATTCAACTCGTGGACT,3109, 1823, 3823, 2407
gene_18537,19344,AGGTCGAGAATTTGGGAGGAG,779,GCAACGCATATGAACGCCAC,3044, 1798, 3798, 2265
gene_13391,16910,GGGTCAGTACCTCCATAGAATGT,498,TGGATGGAAGGAGGAGAGGG,3097, 1792, 3792, 2599
gene_27623,3644,GTACAAAGCCTCAAGTGCAGG,678,GGAACAGGAACACCGGAAGA,3008, 1788, 3788, 2330
gene_19513,6044,TGCTCTGGCGCTCCTACAA,736,GGAACAGGAACACCGGAAGA,3008, 1788, 3788, 2272
gene_6269,6850,ACACTGACATCATCACACCCC,742,GGCCATGAAGCCGATGTTG,3209, 1766, 3766, 2467
gene_4585,120,GGTTGAAAAAAAGTTAACAAAAGCCA,632,GGACAACCAAAAGACTAGAATTGC,3360, 1763, 3763, 2728
gene_6353,17359,CCAAGTCAACTGCACACAAGT,699,CAAATTGCGAGGGATGTGGC,2983, 1738, 3738, 2284
gene_18450,13571,AATTGGAGCTGCAGAGGGAC,710,GCTTGTTCCACTCTCTTTCAACA,3252, 1725, 3725, 2542
gene_22455,14988,GCGGGATCCATGAGTTCTTG,703,ATAACAGAGTTCAGCCCCCG,2862, 1639, 3639, 2159
gene_24053,13401,GCGGGACTTGAATCACTTGA,552,GTACGAACTGGCGTTGGCT,2911, 1634, 3634, 2359
gene_2466,17981,TCGGATGTTGAATGGAGTCGA,758,ACATTGGCTGTTTCAAGGCG,2850, 1630, 3630, 2092
gene_13024,1604,TGCTGAAATCTGCTTCCCCC,727,CAGGGCCATCTGGTACTTCT,2824, 1599, 3599, 2097
gene_16478,15461,TTTTATCCACCTTCCCCAACA,662,TCTGCTGTGCTTGTTGACCA,2969, 1585, 3585, 2307
gene_16233,2091,CGGATCAAACAACCACGGTT,569,AAGGAGTGTTTACCAACCGG,2817, 1566, 3566, 2248
gene_3300,4622,TCCACTCCCATGGCTTCTTT,494,AAGGAGTGTTTACCAACCGG,2799, 1562, 3562, 2305
gene_20599,1404,CACGTGACACTTATTCCCCC,663,CGTTGCACATCTGGTCGAAG,2790, 1554, 3554, 2127
gene_5593,13635,CGCAGCTGAAAACATACGCA,684,TGAAGAATGGTCGAATCTGGGG,2774, 1553, 3553, 2090
gene_19139,14168,CAGTACAACATACGCCCGAGA,753,TGTTGAAGTGAAGTTGCACGG,2794, 1548, 3548, 2041
gene_17761,1803,TGACTAGCAGAGCTTCGCAG,699,CTGATGACAATCCCTCAGCC,2843, 1531, 3531, 2144
gene_799,12173,CGTTGCTAAACATCACTGGTCA,733,TGTTTTCCCCTCTTCTGGCC,2756, 1530, 3530, 2023
gene_2434,19009,CCTGATGACAATCCCTCAGCC,665,GCAGGAATGAGGTCGCCT,2794, 1510, 3510, 2129
gene_30133,7241,GAGCGAATTTACCGGTGCC,606,CGTGAGCTGCGATAACAGAA,2763, 1493, 3493, 2157
gene_27887,9662,AACACCACGTTCACACATCAG,370,AGGGAGACGGATCGAAGTCA,2750, 1486, 3486, 2380
gene_28265,13370,TGCCCTGGAACAAGTTGTCT,777,CCCATAGGAAAGTGGTTCTCCC,2741, 1466, 3466, 1964
gene_12477,10534,GGTTTGTGTAAGCCTGTGCA,724,GCCAGGGATTGTCAGCATTT,2762, 1449, 3449, 2038
gene_11935,15423,CCCATTGTTTTGGCCAGGGA,675,ACGTGAACACTTACCGTGACT,2750, 1447, 3447, 2075
gene_26182,19766,ACCTTAGCATTAGCAGGGATCA,729,GGATGGAAGGAGGAGAGGGA,2830, 1429, 3429, 2101
gene_13875,18377,TCGAACAGGAACTCACTGGA,780,CAGCATAAGCAGCGGGAAC,2668, 1418, 3418, 1888
gene_9368,16839,TGAGGGACTATTGTGTGGTGTG,623,CCCGAATTGTGTGTCCAGGT,2693, 1403, 3403, 2070
gene_23259,19209,CCGATACCCGAACAGTGGTT,589,GGTTGAAGCAGTTACACTTGCA,2632, 1403, 3403, 2043
gene_4678,1591,GGCTATGCCCTCGTTTCTCA,767,GCGCGGAATGTGGAAATCC,2669, 1381, 3381, 1902
gene_27553,18481,CTCCATCCATCCCTCCGTCC,736,CACGAGTCGTTCTGTCTGGT,2646, 1373, 3373, 1910
gene_12597,15087,GATAGCTTCCTCTGGGTTGGT,89,GGGGATGGGGTCAGATGTTT,2590, 1358, 3358, 2501
gene_19197,17179,ATCAATGGAGGACTTCCCGTC,667,TTCTATCTCTGAGGCTGCGG,2571, 1352, 3352, 1904
gene_10546,13493,CCGAGTCCTCACTAACCCAC,517,TCCTTCTCCTCAAGCGACAA,2570, 1340, 3340, 2053
gene_11450,14631,GTGAGTGCTGTCCCAAAAGA,745,TCGCTACCACATCTTGCATG,2579, 1317, 3317, 1834
gene_3882,18153,ATGTGAAAGGGGAACATCGC,247,TGAGAGCACATTGGCTGGAT,2665, 1311, 3311, 2418
gene_10465,9874,GCCTGCTGGTTTCACATAAACA,635,ACGCACAATCTCACTGCTCA,2510, 1285, 3285, 1875
gene_20393,19362,CCTTCTCTTTTTGCCTTCTTCCC,770,CCTGCATCTCCTTGTTCATCTCT,2692, 1281, 3281, 1922
gene_22602,18706,GGTGTGTGCCAACAGAGGG,539,GGCAGAAAAAGGCAGGGAGA,2488, 1262, 3262, 1949
gene_5421,9288,TGCCTATCTTGGATTGCCTGC,746,TCGCCAATTACCCGCACATA,2472, 1220, 3220, 1726
gene_6641,9916,AAACCTCCGCTCGAAACGA,675,GGGTCATCGTGGGTGGTTT,2431, 1213, 3213, 1756
gene_21753,8883,GGCCCAACTTTCCCATCGAT,698,GGAAAGGAACAGGAGGAGTGA,2602, 1148, 3148, 1904
gene_17575,14695,TCCTTGGGATGGAAAGCACA,494,GCGTTGCACATCTGGTCG,2218, 971, 2971, 1724
