GeneID,PrimerPair,PrimerSeq_F,PrimerLoc_F,PrimerSeq_R,PrimerLoc_R,GeneLength_no_padding,GeneLength_with_padding,Primer_coverage
gene_23840,8076,ATTAGGGCATGCCATCTGACC,624,TCTGAAGCCTGTGACCTGAC,2399, 1280, 3280, 1775
gene_25516,7919,GGGGGCATTTTGGTGATCTTG,694,CACGCTCGATTTGAGGAGGA,2409, 1284, 3284, 1715
gene_7950,552,GCGGTATATGCAATGCCCTG,821,GCTTCCATATCTCGACGCGA,2411, 1289, 3289, 1590
gene_8306,2398,TCTCATGACCGTGCTTGCC,42,CGATCTGAAGCCTGTGACCT,2422, 1302, 3302, 2380
gene_26505,8154,TTCACCTGCCACCCAAGAG,613,GATGGAGGTGGAGGAAGGTG,2536, 1395, 3395, 1923
gene_14041,9962,GCTACTGAGACTTCGTCCGC,163,GGAAGGCTGTTCAATACTTGCA,2532, 1408, 3408, 2369
gene_22265,9825,ATGACTGGTACACGCTTGCG,748,AGTGCCAGAATTGTAGCATGG,2740, 1427, 3427, 1992
gene_2178,6223,GTGGTTTTTGGACTGAGCCG,827,TGAACACGCAAGCCAGAATT,2941, 1429, 3429, 2114
gene_16108,9162,TCTAACCTAGGGACACGAGAGG,750,AGATTGGACTGTCAAGCCCC,2640, 1504, 3504, 1890
gene_23422,5004,GCGGATTGAATTAGGGCCCA,863,GCATCGCACTGCCATTAGGA,2673, 1512, 3512, 1810
gene_6347,5720,GCTGGTCCTCATTTGATTGGTC,361,TGCCAGCAGGAAAGCTTTGA,2887, 1515, 3515, 2526
gene_4447,2847,TGCTCAAGCTTGGTTTGGGG,186,GGGAAGGGTCAAAGAGGCAA,2640, 1519, 3519, 2454
gene_7548,3641,CGGTGTTTGAGTAGGTTCGGT,452,TCTGCTAGTTCCGCCATTTC,2650, 1531, 3531, 2198
gene_5466,5378,TTCAAAGCCAAGGCCGATTG,359,ACCCCATACCCCATGAAAAACA,2732, 1533, 3533, 2373
gene_27559,3634,CCAGGTGAACGATCGAAGCA,862,CCAGGCGGTACAGGTCAATA,2758, 1545, 3545, 1896
gene_2476,6262,GTGGAGTGCATAAAGGCTGC,750,GCTCCCTGCCCAAAATGTATG,2800, 1573, 3573, 2050
gene_20660,7293,GGTGACGAGCATATAAGCCCA,855,GGCAACGCGGGGAATATTTT,2763, 1613, 3613, 1908
gene_20332,3751,CCGCAAGTCTCATTCCCAGAT,560,GCGGACTACACATTGGTCGT,2766, 1631, 3631, 2206
gene_23800,6586,TAGCGCAATGTGGATTCCCA,872,GCATGAGTTGAGAGTGAACAGTG,2843, 1674, 3674, 1971
gene_2285,3452,GGTCACACAGCAAATCAACGT,818,GGGTGCTGTCTTGATGGTGA,2805, 1684, 3684, 1987
gene_4509,6599,CCAGGCCAACTTTTCGTTCA,792,GGGAATAGGATGGAGCTGGA,2830, 1711, 3711, 2038
gene_9962,8872,GGCTGATCCCACGAAATCTCT,869,TGCTCCCGCGAGTTGAAAG,2890, 1717, 3717, 2021
gene_944,4380,GCAAATGTCATGACACCAGCT,866,CCCAATCAATCCCCCAAACC,2967, 1758, 3758, 2101
gene_2222,2800,GCCAGCAGAAATTCAGCAACT,801,CCTCCCTGAAGGCGTGAAAA,2888, 1763, 3763, 2087
gene_1471,4577,GACCATGGATTCCCCTCGTT,817,ATCCTCACCCTTCCGACTCC,2894, 1775, 3775, 2077
gene_19513,8482,TGATCTTCTCCCGCCAAACC,856,GGAACACCGGAAGATCATGT,3002, 1788, 3788, 2146
gene_19277,1978,GCGGATATAGTCCCGGTGAG,857,CATTGGTGAACTGCATGCGG,2972, 1814, 3814, 2115
gene_25576,9101,GGGATGGGATCTAGCAACCAG,206,AGGGGAAGAACGAGCAAGAA,3130, 1827, 3827, 2924
gene_26653,8413,TGTGGATATAGAGCGCTGTCT,322,AGCTGGAGGTTCAAGATGGA,3096, 1832, 3832, 2774
gene_8228,9278,TGGGCTCGATATCTGGTTCA,554,TCCCCCCCAACCTTTTTCTT,3106, 1838, 3838, 2552
gene_11781,8105,GGCCGAGGATGGAAAACTGA,757,CCACCGACGATCGACCTG,3035, 1918, 3918, 2278
gene_25175,6763,CAACTGTGACCGAGGATGGA,750,TAACCCCTCCACCGACGAT,3042, 1919, 3919, 2292
gene_12609,9728,GGACTCTTTTTTTCCCCTCGT,741,GCCTTGCACATTCAAGTAGAAGT,3329, 1994, 3994, 2588
gene_598,9746,TCTTTGAGCGGAATGTGGAAGT,792,GGCTGACACATCATCAGACGA,3493, 2367, 4367, 2701
gene_10601,6628,TTTGCTAAGCTAGGGGGCAC,847,CGCTTAATGGGATGTGGTTTCC,3292,1295,3295,2445
gene_5855,7790,CGTACAAACGCCCGAAAAGG,763,AGTGTCTGCAATCGCAAACA,2668,1394,3394,1905
gene_19689,4559,GGGCCTCCAACAGTCTGAAT,619,GCAGGGTCCTTATAGAACACCA,2617,1481,3481,1998
gene_7283,9006,CTGGCTGGGTTGATGATGGT,847,TCGTTCAAGAACACCTCATGT,3246,1493,3493,2399
gene_3897,4500,GCACAATGGCCAAACAGACA,761,TCGACGACGACGATGATGAT,3081,1500,3500,2320
gene_15746,7426,GGAATTCGCTCTGTTTTCGGA,776,GGAGGGTGTTTCTGGCTATGT,3236,1504,3504,2460
gene_4432,6622,ACTTTTCAAAAGGGCATGCTGA,808,TGAGAGCTGGTTTGGACAAA,2716,1545,3545,1908
gene_2132,9706,TGACTGGACGTGACTGCAAA,840,ACGCCTCAGCCCGGTATA,3284,1547,3547,2444
gene_19458,9722,GGAATTACGCAAGCCAGGTG,866,GGAACAGTAAGCCCTCTCCT,2753,1574,3574,1887
gene_23826,9267,GTGGAGTTCTGGAACGAGCC,852,GCTTCTGTTGTTGGAACTGCT,3246,1578,3578,2394
gene_7260,4314,CGTCCAGGAAAGCCATGAGC,861,ATTGATCATCACCCCCAGGAG,3401,1585,3585,2540
gene_13303,4142,CCAGGGTCCGACAAAGAGAT,873,GTACGCCATTCACATCAGGC,3271,1609,3609,2398
gene_29384,6592,ATTTCTCCAGGACTGCGCAA,752,GTGGGGGGTATCGGAGAGA,2970,1663,3663,2218
gene_13932,2796,GGCTGGACTAGTGCTGTGAT,880,CCACCTTACAGAAGTGCATGT,3519,1714,3714,2639
gene_19204,9714,CCCCCTCATTCTCGCTTAACT,861,GTGAGTTCCACTTCCACGCA,3441,1745,3745,2580
gene_7107,7294,CCACTGCCAACCAATCGAAA,854,AGTGTTGTTGCTCGACCAGG,3379,1774,3774,2525
gene_10618,6794,CGACGGATACCTTCGGACAG,876,GTTGCCAAGTTGAGTGCTTG,3648,1775,3775,2772
gene_23183,3704,GCTCGAAGTTGTGTTGACCA,845,GGGAGAGCATTGGACAATCCT,3704,1881,3881,2859
